NO textures/path_to_the_north_texture
SO textures/path_to_the_south_texture
WE textures/path_to_the_west_texture
EA textures/path_to_the_east_texture
F 220,100,0
C 208,6,4


11111
10E01
100001
100001
100101
101 101
111111